Airport Code,Year,Month,Domestic Flights,International Flights,Total Flights
EWR,2012,Jun,26295,8337,34632
LGA,1991,Mar,23670,1440,25110
SWF,2007,Dec,1381,8,1389
JFK,1997,Mar,17723,9030,26753
LGA,2009,Dec,25136,1918,27054
EWR,1992,Dec,30557,2171,32728
EWR,1983,Oct,21743,174,21917
JFK,2000,Aug,18579,11333,29912
LGA,1987,Jun,27269,121,27390
EWR,1996,Sep,33738,3317,37055
EWR,1997,Nov,30983,3917,34900
LGA,1995,Jun,25498,1855,27353
LGA,1996,Jun,24988,2015,27003
LGA,1981,Mar,22517,0,22517
LGA,1997,Dec,25365,1899,27264
LGA,2002,Jan,25924,1244,27168
LGA,1983,Dec,23553,0,23553
JFK,1984,Oct,15318,6931,22249
JFK,2000,Nov,17358,9965,27323
LGA,1995,May,25953,1791,27744
LGA,1978,Jan,19107,0,19107
LGA,1986,Sep,26855,117,26972
JFK,1991,Nov,10441,7620,18061
SWF,2007,Jan,1181,0,1181
LGA,1979,Dec,20788,0,20788
JFK,1999,Sep,16796,10236,27032
LGA,1993,Feb,22261,1288,23549
LGA,2007,Oct,30660,1807,32467
LGA,1978,Mar,21745,0,21745
LGA,2006,Feb,27026,1638,28664
EWR,1989,Apr,25765,1149,26914
SWF,2009,Aug,668,0,668
JFK,2006,Jun,18341,11101,29442
LGA,1983,Apr,21784,0,21784
LGA,1988,Oct,27664,1330,28994
JFK,1994,Aug,20915,10067,30982
EWR,1981,Jan,12896,72,12968
LGA,1997,Sep,25751,1918,27669
EWR,2007,May,29084,7498,36582
LGA,1988,Feb,25036,1191,26227
LGA,2007,Mar,31136,1683,32819
JFK,1987,Jan,12234,6465,18699
SWF,2006,May,800,0,800
LGA,2001,Oct,24533,1364,25897
LGA,2013,Sep,26762,2783,29545
LGA,2007,Jun,28445,1767,30212
EWR,1979,Oct,13957,277,14234
SWF,2011,May,724,0,724
JFK,1995,Dec,16117,9627,25744
JFK,1991,Jul,12290,9274,21564
SWF,2011,Jun,754,0,754
EWR,1983,Aug,20632,275,20907
LGA,1999,Mar,27895,2081,29976
JFK,2010,May,19999,12245,32244
LGA,1991,Apr,24321,1422,25743
JFK,1978,Aug,15632,8085,23717
SWF,2013,Aug,686,1,687
SWF,2006,Jun,775,8,783
SWF,2009,Jan,648,0,648
LGA,2002,Dec,27811,1585,29396
JFK,1988,Jun,14824,8570,23394
LGA,1998,Jan,24810,1847,26657
LGA,1991,Jul,25390,1571,26961
EWR,1991,Aug,29363,2059,31422
LGA,2014,May,27438,2687,30125
LGA,2010,Apr,28395,2200,30595
EWR,1992,Feb,27913,1872,29785
EWR,1988,Aug,28854,759,29613
EWR,1981,May,13879,123,14002
EWR,1981,Sep,13203,145,13348
ACY,2014,Dec,795,1,796
JFK,1978,Feb,12623,5379,18002
JFK,1994,Jul,20916,10110,31026
ACY,2013,Aug,930,6,936
SWF,2014,Apr,616,0,616
EWR,2004,Jan,27808,5541,33349
EWR,1989,Sep,26287,1422,27709
EWR,2013,Jul,26630,8399,35029
LGA,2008,Dec,25430,1786,27216
LGA,2009,Apr,26694,1848,28542
EWR,1987,Nov,26789,292,27081
LGA,1978,May,21916,0,21916
EWR,1997,Jan,33162,3163,36325
LGA,2014,Aug,28474,2846,31320
JFK,1977,Apr,14210,6627,20837
EWR,2003,Feb,22873,4681,27554
LGA,1992,Oct,24990,1520,26510
EWR,1994,Nov,32078,2311,34389
SWF,2006,Jan,834,1,835
LGA,2009,Jul,28727,1898,30625
EWR,2010,Feb,20576,6579,27155
LGA,2013,Jul,27507,2797,30304
JFK,1992,Dec,17345,8227,25572
EWR,2014,Jun,25329,8031,33360
EWR,2008,Aug,28863,8694,37557
LGA,1983,Oct,24200,0,24200
JFK,1978,Jan,13642,6275,19917
LGA,1999,Nov,26451,1955,28406
SWF,2013,Dec,618,5,623
LGA,2008,Apr,29353,1952,31305
EWR,1995,Dec,29699,2731,32430
EWR,2009,Jan,25447,7410,32857
JFK,2010,Oct,20689,11938,32627
JFK,2003,Mar,14721,8851,23572
LGA,1983,Mar,22381,0,22381
LGA,2003,Oct,29977,1739,31716
LGA,1994,Jan,22506,1345,23851
JFK,2007,Oct,24941,11547,36488
JFK,1984,May,15990,6746,22736
SWF,2013,Feb,552,4,556
EWR,2011,Feb,20788,7165,27953
LGA,2014,Feb,21689,2245,23934
EWR,1978,Feb,10379,145,10524
JFK,1977,Feb,12613,5851,18464
LGA,1989,Jul,25227,1499,26726
EWR,1996,Dec,33347,3219,36566
EWR,1994,Jul,32221,2865,35086
SWF,2006,Jul,801,14,815
JFK,2009,Feb,20426,10293,30719
SWF,2013,Jul,694,2,696
LGA,1986,Feb,22854,91,22945
EWR,2010,Aug,28551,8985,37536
JFK,2011,Feb,17940,10506,28446
LGA,1993,Mar,23744,1429,25173
JFK,2003,Jun,12768,8932,21700
EWR,1978,Nov,12456,195,12651
JFK,2013,Jul,21695,15359,37054
SWF,2007,Jul,1437,2,1439
LGA,1984,Dec,24968,32,25000
JFK,1994,Sep,18675,9078,27753
EWR,2009,Dec,24945,7372,32317
JFK,2000,Sep,18162,10306,28468
LGA,2006,Aug,32401,1959,34360
JFK,1992,Sep,17539,8908,26447
EWR,1980,Sep,12640,124,12764
EWR,1982,Mar,12940,163,13103
JFK,1994,Apr,18271,8326,26597
JFK,2008,Oct,23110,12031,35141
SWF,2013,Jun,588,2,590
LGA,1992,May,25444,1487,26931
LGA,1984,Jun,25419,0,25419
JFK,2005,Jun,18496,10058,28554
JFK,1992,Jul,18347,9738,28085
JFK,1988,Jan,13616,7360,20976
EWR,1977,Feb,9914,176,10090
EWR,2010,May,25187,8151,33338
EWR,2003,Nov,27227,5026,32253
EWR,1989,Dec,26891,1416,28307
EWR,1997,Sep,32946,4102,37048
EWR,1987,Feb,25038,253,25291
LGA,2008,Jul,30190,2006,32196
JFK,1986,Jan,13675,6490,20165
JFK,2010,Mar,20459,11476,31935
EWR,1994,Sep,31914,2534,34448
JFK,2009,Nov,20145,10915,31060
LGA,1977,Jun,21312,0,21312
JFK,2008,Jan,22860,11997,34857
LGA,1984,Jan,23725,0,23725
JFK,1986,Jun,12796,7099,19895
LGA,1998,Nov,26266,2115,28381
JFK,1997,Jun,18084,10304,28388
JFK,1999,Dec,16799,9984,26783
LGA,1992,Sep,24515,1461,25976
JFK,1982,Mar,14374,5263,19637
LGA,2006,Jan,30122,1738,31860
EWR,1985,Oct,29431,362,29793
ACY,2012,May,1051,4,1055
EWR,1983,May,16753,214,16967
SWF,2008,May,1234,0,1234
JFK,2014,Jan,17193,12599,29792
JFK,2011,Nov,20046,11396,31442
EWR,2012,Sep,24360,7613,31973
EWR,1978,Oct,13118,265,13383
SWF,2013,Nov,606,2,608
EWR,2009,Feb,23791,6848,30639
LGA,1991,Oct,25707,1448,27155
SWF,2006,Nov,748,10,758
LGA,2010,May,28200,2189,30389
EWR,1986,Feb,25491,271,25762
EWR,2003,Aug,27984,6164,34148
EWR,1990,Oct,28717,1885,30602
JFK,1988,Aug,12427,9446,21873
JFK,1995,Apr,16734,9003,25737
LGA,2000,Aug,28763,1909,30672
EWR,2009,Jul,26816,8547,35363
JFK,2003,Sep,13052,8930,21982
LGA,1996,May,25897,2139,28036
JFK,2011,May,22166,12477,34643
SWF,2012,Dec,648,3,651
JFK,1979,Aug,15520,8182,23702
JFK,1989,Jun,10935,8773,19708
LGA,2009,May,26921,1916,28837
EWR,2013,Mar,25987,8111,34098
LGA,2013,Jan,26918,2739,29657
LGA,1993,Nov,24676,1486,26162
EWR,1994,Mar,32741,2794,35535
LGA,2007,Feb,26912,1523,28435
EWR,1979,Nov,13049,162,13211
LGA,1996,Mar,24989,2023,27012
SWF,2007,Oct,1361,4,1365
LGA,2014,Sep,26667,2815,29482
LGA,2001,Nov,24516,1405,25921
EWR,2014,May,22541,7991,30532
LGA,1980,Nov,19463,0,19463
JFK,1987,Jul,14333,8692,23025
EWR,1982,Oct,13372,155,13527
SWF,2008,Oct,733,4,737
EWR,1981,Oct,14036,118,14154
JFK,2013,Apr,19376,12423,31799
JFK,1987,Jun,13438,7816,21254
LGA,2011,Feb,24815,1554,26369
JFK,1993,Aug,18966,9726,28692
LGA,2008,May,29942,2005,31947
LGA,2009,Aug,28311,1892,30203
LGA,2007,Nov,29336,1664,31000
EWR,2002,Mar,27993,4973,32966
LGA,1985,Jul,27075,185,27260
LGA,1984,Sep,24858,0,24858
JFK,1982,Jul,15145,7575,22720
ACY,2014,Jul,1038,4,1042
EWR,1977,Jan,10471,185,10656
LGA,2001,Jan,32162,1732,33894
EWR,1978,Apr,12076,263,12339
EWR,1985,Jun,27776,343,28119
EWR,1991,Jun,27298,1819,29117
LGA,1978,Oct,22992,0,22992
LGA,1999,May,26633,2074,28707
EWR,1980,Feb,12128,127,12255
LGA,2001,Mar,29317,1545,30862
LGA,2000,Oct,33114,1915,35029
EWR,1978,Jun,12153,315,12468
EWR,1977,May,10811,255,11066
LGA,1997,Aug,26313,2009,28322
EWR,2005,Nov,28918,5571,34489
LGA,1995,Aug,26147,2083,28230
JFK,1987,Dec,13814,7227,21041
LGA,2002,Oct,28582,1825,30407
LGA,1991,Nov,23919,1368,25287
EWR,1979,Feb,11395,201,11596
JFK,2006,Jul,20315,11940,32255
LGA,1987,Feb,25054,94,25148
JFK,1992,Apr,15829,7756,23585
EWR,2012,Mar,26908,8436,35344
EWR,2014,Nov,25454,7106,32560
SWF,2013,May,615,0,615
JFK,2005,Dec,18034,9807,27841
EWR,1992,Mar,30007,2086,32093
JFK,1991,Oct,11283,8039,19322
JFK,1996,Dec,17926,9418,27344
ACY,2014,Sep,845,5,850
EWR,2002,Apr,27271,5158,32429
JFK,2014,Apr,20041,13568,33609
LGA,1989,Nov,24766,1646,26412
EWR,2011,Apr,25024,8519,33543
SWF,2010,May,648,0,648
JFK,2008,Mar,23760,12392,36152
LGA,1986,Apr,26039,117,26156
EWR,2012,Jul,26103,8793,34896
LGA,2012,May,28893,2112,31005
EWR,2003,May,27625,5419,33044
LGA,1991,Jan,24115,1366,25481
JFK,1982,Jan,13911,5461,19372
EWR,1987,Oct,27525,339,27864
LGA,2000,May,27749,1934,29683
LGA,2010,Sep,27950,2089,30039
SWF,2008,Aug,1244,0,1244
LGA,1985,Mar,25512,56,25568
EWR,1993,Jul,34226,2639,36865
EWR,1985,Feb,25153,223,25376
JFK,1993,Mar,16513,7879,24392
EWR,2011,May,25494,8347,33841
EWR,2011,Jan,22068,7882,29950
SWF,2011,Mar,751,8,759
EWR,1984,Sep,25383,329,25712
SWF,2006,Oct,748,10,758
EWR,1988,Jan,25836,813,26649
SWF,2008,Sep,710,0,710
LGA,2013,Apr,28092,2726,30818
LGA,1997,Feb,24064,1786,25850
LGA,2002,Apr,27458,1527,28985
JFK,2010,Sep,20113,11967,32080
EWR,2006,Sep,27869,6845,34714
JFK,1980,Feb,13616,5789,19405
ACY,2014,Jan,777,0,777
LGA,1989,Mar,24386,1325,25711
EWR,1988,Jun,26898,866,27764
LGA,1994,Apr,24815,1546,26361
LGA,2014,Jul,27500,2702,30202
EWR,2012,Oct,23732,7215,30947
EWR,1997,Feb,31051,2905,33956
LGA,1988,Sep,25701,1295,26996
EWR,1990,Sep,27133,1967,29100
SWF,2006,Aug,810,3,813
LGA,1994,Feb,20400,1191,21591
LGA,1988,Nov,26060,1273,27333
LGA,1990,Sep,25462,1500,26962
LGA,1981,May,23551,0,23551
EWR,2013,Feb,22039,6997,29036
EWR,1991,Dec,28574,1801,30375
EWR,1984,Jun,24782,272,25054
JFK,1986,Mar,13484,6502,19986
EWR,2011,Dec,26391,8143,34534
SWF,2010,Sep,661,0,661
JFK,1997,Dec,18476,9800,28276
LGA,2011,Jul,28722,1851,30573
EWR,1991,Apr,26972,1635,28607
EWR,1977,Nov,10926,210,11136
SWF,2011,Jul,780,0,780
JFK,1985,Jun,14359,7737,22096
LGA,2006,Mar,31529,1916,33445
JFK,2009,Aug,23894,13400,37294
LGA,2006,May,31467,1910,33377
LGA,2004,Mar,30987,1734,32721
EWR,1990,Dec,27634,1765,29399
LGA,1983,Jul,24662,0,24662
JFK,1996,Apr,16686,9630,26316
LGA,1999,Feb,24323,1860,26183
EWR,1991,Jan,27436,1852,29288
JFK,1981,Feb,13982,5114,19096
LGA,1980,Jan,21288,0,21288
LGA,2012,Mar,29190,2080,31270
LGA,2014,Mar,27577,2738,30315
JFK,1979,Jul,15531,8174,23705
EWR,1986,Aug,32296,442,32738
EWR,1991,Mar,27885,1694,29579
LGA,1992,Feb,23346,1370,24716
LGA,1985,May,26190,62,26252
EWR,1981,Dec,12791,111,12902
EWR,1996,Aug,36419,3750,40169
SWF,2009,Apr,652,0,652
JFK,1984,Mar,14919,6037,20956
JFK,1988,Feb,12844,6875,19719
SWF,2011,Dec,790,0,790
JFK,1995,Oct,18424,9746,28170
LGA,1993,Jun,25057,1528,26585
EWR,2009,Jun,25827,7833,33660
JFK,1983,Oct,15496,6519,22015
JFK,1982,Nov,14354,5043,19397
JFK,1981,Mar,15509,5729,21238
JFK,1989,Jan,11653,7814,19467
LGA,2008,Feb,26725,1672,28397
LGA,1992,Jun,25573,1480,27053
JFK,1992,May,16673,8260,24933
EWR,2002,Nov,26568,4666,31234
JFK,2003,Apr,14152,7835,21987
SWF,2006,Apr,750,2,752
LGA,1991,May,24733,1479,26212
JFK,1997,Aug,19051,11174,30225
LGA,2004,Sep,29179,1911,31090
JFK,1981,Oct,13663,5841,19504
JFK,2000,Jul,17869,11536,29405
LGA,1996,Jul,24883,2041,26924
LGA,1982,Jun,21427,0,21427
JFK,1997,Apr,17175,9248,26423
LGA,2000,Sep,30148,1799,31947
LGA,1993,Sep,24962,1517,26479
LGA,1989,Oct,26333,1760,28093
SWF,2010,Feb,538,0,538
JFK,2000,Dec,15279,10073,25352
LGA,2004,Jun,30198,1938,32136
LGA,2000,Apr,27014,1898,28912
LGA,2006,Dec,29843,1779,31622
JFK,1977,Mar,13843,6489,20332
JFK,1980,Oct,14249,6049,20298
JFK,1993,Dec,17199,8316,25515
SWF,2010,Dec,689,0,689
JFK,2008,Sep,22421,12045,34466
JFK,1993,Jun,18094,8820,26914
ACY,2012,Feb,756,2,758
EWR,1996,Apr,32033,3058,35091
JFK,1988,Dec,11637,7891,19528
LGA,2000,Nov,32759,1789,34548
EWR,2013,Oct,26869,7546,34415
JFK,2005,Jan,16531,9652,26183
LGA,1993,Jul,25756,1576,27332
JFK,1990,May,12103,8269,20372
JFK,1978,Jun,15108,7344,22452
JFK,2013,Aug,21921,15446,37367
JFK,2001,Sep,11583,8137,19720
JFK,2010,Jul,21825,14188,36013
JFK,1986,Apr,13153,6485,19638
SWF,2013,Oct,648,0,648
LGA,1980,Jul,22224,0,22224
JFK,2009,Mar,22840,11600,34440
JFK,1978,Oct,15262,6794,22056
EWR,1986,Jan,28281,308,28589
SWF,2014,Jan,570,0,570
JFK,1989,Sep,12186,8680,20866
EWR,1988,Jul,27232,980,28212
EWR,1994,Jun,32071,2720,34791
EWR,2001,Dec,25981,5025,31006
JFK,1992,Feb,13431,6981,20412
EWR,1992,Jul,30969,2630,33599
LGA,1986,Oct,27216,124,27340
EWR,2010,Jul,25786,9125,34911
LGA,2004,Apr,30604,1731,32335
JFK,2009,Jul,23820,13381,37201
JFK,1984,Aug,17173,7876,25049
LGA,2011,Mar,29806,1851,31657
EWR,1989,Jul,27097,1681,28778
LGA,2006,Jun,30018,1888,31906
LGA,1988,Aug,27227,1348,28575
LGA,2006,Sep,29955,1821,31776
SWF,2008,Feb,1371,0,1371
JFK,1982,Oct,15038,6135,21173
EWR,1977,Mar,11117,230,11347
EWR,2012,Aug,29700,8671,38371
LGA,2012,Jul,27491,2771,30262
LGA,2005,Nov,29685,1803,31488
JFK,1996,Nov,17955,8928,26883
EWR,1996,Jan,26849,2623,29472
JFK,1983,May,14977,6331,21308
JFK,1986,Jul,13178,7803,20981
EWR,2013,Apr,26287,8116,34403
LGA,1979,Feb,18260,0,18260
LGA,1997,Mar,26118,1947,28065
JFK,1993,Jul,18831,9751,28582
ACY,2013,Apr,770,3,773
LGA,1986,Jul,26545,124,26669
LGA,1977,Jul,21439,0,21439
LGA,1983,Jan,21711,0,21711
LGA,1983,Nov,23264,0,23264
EWR,1983,Jun,18856,248,19104
SWF,2014,Oct,632,0,632
LGA,1978,Aug,23241,0,23241
JFK,2014,May,21597,14355,35952
LGA,1990,Jan,26842,1683,28525
LGA,1995,Nov,24348,1874,26222
SWF,2009,May,656,0,656
EWR,1996,Nov,32563,3021,35584
JFK,2003,Jan,14303,9045,23348
LGA,2005,Apr,30486,2076,32562
JFK,2006,Mar,18419,10111,28530
ACY,2013,Feb,680,4,684
JFK,1991,Jan,11031,7615,18646
SWF,2006,Feb,773,2,775
SWF,2007,Mar,1318,0,1318
LGA,1982,Feb,18756,0,18756
JFK,1984,Jul,16791,7925,24716
EWR,2002,Oct,28185,5076,33261
LGA,1986,May,26962,125,27087
JFK,1991,Dec,13564,7471,21035
JFK,1997,Sep,17662,10233,27895
JFK,1993,Sep,17451,8784,26235
LGA,2002,Jun,27273,1701,28974
JFK,1998,Apr,16693,9674,26367
JFK,1995,Jul,18289,11142,29431
EWR,1986,Jun,30395,378,30773
JFK,1979,Oct,14677,6932,21609
EWR,1994,Jan,29571,2591,32162
SWF,2012,Mar,821,0,821
JFK,1990,Oct,12198,8215,20413
EWR,2009,Oct,25704,7209,32913
EWR,2009,Aug,26470,8623,35093
LGA,1979,Nov,21439,0,21439
JFK,2009,May,23604,12467,36071
JFK,1996,Sep,19070,10104,29174
EWR,2009,Sep,24485,7119,31604
LGA,2006,Nov,29626,1802,31428
EWR,2014,Jul,26272,8966,35238
JFK,2010,Nov,20500,11338,31838
JFK,1990,Mar,12669,8101,20770
JFK,2008,Jun,23388,12933,36321
JFK,1982,Feb,13207,4809,18016
JFK,2007,Aug,25815,13187,39002
EWR,2005,Jan,26305,5908,32213
SWF,2012,Apr,768,0,768
JFK,1979,Jun,14392,7163,21555
LGA,1980,Jun,21747,0,21747
EWR,2010,Sep,23832,7553,31385
EWR,2005,Sep,27893,6327,34220
JFK,1997,Feb,15859,8011,23870
LGA,2002,Jul,28336,1775,30111
JFK,2000,Jun,16991,10657,27648
LGA,1978,Jul,22122,0,22122
JFK,2004,Nov,16766,9264,26030
JFK,2012,Feb,18886,10810,29696
JFK,1992,Oct,18003,8515,26518
JFK,1995,Feb,14165,7800,21965
EWR,1991,Oct,28955,1908,30863
EWR,1998,Jan,30117,4020,34137
EWR,1995,Nov,29885,2484,32369
EWR,2012,Dec,23535,7521,31056
LGA,1985,Feb,22795,48,22843
EWR,1992,Jan,28512,1925,30437
JFK,1992,Jan,13807,7307,21114
JFK,1988,Sep,11411,8599,20010
JFK,2008,Feb,21447,11140,32587
EWR,1993,Jun,32442,2507,34949
LGA,2001,Dec,24478,1296,25774
LGA,2009,Sep,26923,2057,28980
LGA,1986,Jan,25836,101,25937
JFK,2009,Oct,20658,11416,32074
EWR,1986,Jul,31956,405,32361
LGA,2010,Jan,26458,1938,28396
JFK,1983,Sep,15359,6723,22082
EWR,1994,Oct,32595,2531,35126
JFK,1987,Oct,13833,7307,21140
EWR,1979,Mar,13188,255,13443
EWR,2009,Mar,26940,8098,35038
EWR,1988,Sep,28627,833,29460
LGA,1983,Aug,25204,0,25204
JFK,2004,Apr,15497,9009,24506
LGA,1981,Sep,19539,0,19539
LGA,2004,Nov,30652,2069,32721
JFK,1979,Feb,12512,5817,18329
LGA,2001,Sep,20817,1138,21955
EWR,1987,Mar,28581,293,28874
SWF,2010,Jan,632,0,632
LGA,2000,Jul,27223,1859,29082
JFK,2011,Oct,21090,12188,33278
JFK,1998,Mar,17597,9617,27214
EWR,2003,Mar,27983,5701,33684
LGA,1993,Apr,25110,1459,26569
EWR,1983,Dec,22089,170,22259
LGA,1992,Aug,25590,1509,27099
EWR,1985,Jul,29074,416,29490
LGA,1980,Feb,19575,0,19575
EWR,1980,Oct,13250,128,13378
EWR,2008,Jun,27716,8087,35803
EWR,2004,Apr,29316,5997,35313
EWR,1981,Mar,13360,94,13454
LGA,2012,Feb,27139,1929,29068
EWR,1995,Jul,31495,3121,34616
LGA,2001,Jun,28510,1768,30278
JFK,1981,Jul,15775,7305,23080
LGA,1992,Jan,24009,1425,25434
SWF,2011,Feb,624,6,630
SWF,2014,Mar,586,0,586
EWR,2012,Feb,23935,7531,31466
JFK,1980,Aug,15037,7623,22660
LGA,1991,Feb,20750,1278,22028
JFK,1989,Apr,11211,7922,19133
EWR,1998,Feb,28515,3771,32286
JFK,2007,Jan,24181,10922,35103
JFK,2007,Jul,25129,13110,38239
LGA,1992,Jul,25952,1525,27477
LGA,1986,Aug,26589,124,26713
JFK,2005,Feb,15941,8551,24492
JFK,1979,Apr,12533,6730,19263
JFK,1985,Aug,15257,8230,23487
LGA,1980,May,21528,0,21528
EWR,1978,Dec,13021,216,13237
JFK,1994,Jan,15764,8162,23926
EWR,2008,Mar,27985,7894,35879
LGA,2004,Jul,29823,1953,31776
LGA,1990,Dec,24243,1482,25725
JFK,1990,Sep,12195,8813,21008
LGA,2010,Jul,27686,2177,29863
LGA,1983,Sep,24061,0,24061
EWR,1981,Jul,15167,187,15354
LGA,2008,Jun,28630,1866,30496
EWR,1990,Aug,29577,2322,31899
SWF,2011,Nov,734,0,734
EWR,1992,May,30466,2229,32695
JFK,1989,Oct,12172,8249,20421
JFK,1993,Nov,16792,7885,24677
JFK,1985,May,14699,7339,22038
JFK,1978,Mar,15056,6523,21579
JFK,1993,Jan,17541,8311,25852
JFK,1978,Dec,15109,6412,21521
LGA,2009,Oct,27630,2088,29718
JFK,1999,Apr,16843,9244,26087
LGA,1999,Sep,25182,2010,27192
LGA,2011,Sep,28118,1901,30019
JFK,1994,Mar,17808,8241,26049
EWR,2007,Jun,27440,7707,35147
JFK,2006,Apr,18235,9956,28191
EWR,1991,May,27910,1774,29684
EWR,2006,Jul,29196,7862,37058
LGA,2005,Aug,31454,1978,33432
EWR,2014,Mar,25609,8021,33630
EWR,2001,Nov,26283,4447,30730
LGA,2011,Aug,27740,1789,29529
JFK,1988,May,14335,7991,22326
JFK,1977,May,14459,6942,21401
JFK,1999,Aug,18123,11449,29572
EWR,1977,Oct,11692,207,11899
LGA,1989,Feb,23924,1158,25082
EWR,1990,Jul,28430,2390,30820
LGA,2013,Oct,29336,3011,32347
EWR,1990,Feb,24570,1258,25828
ACY,2013,Jan,716,2,718
JFK,2007,Jun,24097,12150,36247
LGA,1997,Nov,24439,1920,26359
EWR,1993,Mar,29828,2117,31945
JFK,1993,Oct,17356,9034,26390
JFK,1983,Jan,14466,5569,20035
LGA,1998,Sep,25435,1540,26975
ACY,2013,Nov,796,2,798
LGA,2010,Mar,28064,2112,30176
LGA,1980,Sep,21271,0,21271
JFK,2001,Jun,16271,9826,26097
EWR,1992,Jun,30428,2414,32842
JFK,1997,Jul,19265,11056,30321
LGA,2009,Nov,26622,1933,28555
LGA,2003,Jul,29519,1681,31200
EWR,2005,Mar,30030,6216,36246
JFK,1989,Nov,11696,7539,19235
ACY,2013,Jun,908,5,913
JFK,1979,Mar,14914,6604,21518
EWR,2013,Nov,25544,6949,32493
SWF,2008,Jul,1241,0,1241
EWR,1986,Sep,30267,333,30600
EWR,2005,Aug,30340,7278,37618
LGA,1998,Feb,23996,1823,25819
JFK,2002,May,13893,8650,22543
JFK,1988,Jul,15163,9597,24760
JFK,2011,Jul,23061,14604,37665
JFK,1995,Nov,16505,9105,25610
LGA,1993,Aug,26250,1585,27835
JFK,2010,Apr,20120,10763,30883
JFK,1977,Oct,14245,7089,21334
LGA,1996,Jan,21750,1725,23475
EWR,2007,Oct,28013,7507,35520
EWR,1993,Oct,33157,2692,35849
LGA,1979,Apr,19994,0,19994
LGA,2005,Feb,27650,1900,29550
JFK,1988,Nov,11082,7411,18493
EWR,2014,Aug,26959,8438,35397
EWR,2008,Jul,29330,8576,37906
JFK,1979,Nov,13810,5906,19716
SWF,2007,Nov,1402,4,1406
EWR,1988,Mar,27566,901,28467
JFK,1999,May,17428,9775,27203
SWF,2012,Jul,794,0,794
EWR,1983,Mar,16116,222,16338
LGA,2006,Oct,31048,1845,32893
EWR,2013,Sep,25082,7263,32345
ACY,2014,Jun,1047,7,1054
EWR,2007,Aug,29273,8479,37752
LGA,1984,Mar,23970,0,23970
EWR,2008,Dec,26417,6854,33271
EWR,1989,Nov,27111,1340,28451
EWR,1977,Sep,11120,235,11355
JFK,1995,May,17583,9002,26585
LGA,1997,May,25903,2075,27978
EWR,2008,Apr,28126,8343,36469
JFK,2012,Jun,20668,13341,34009
EWR,2010,Mar,25817,8256,34073
SWF,2013,Apr,618,2,620
JFK,1990,Aug,13184,9558,22742
JFK,2013,Dec,19542,13541,33083
JFK,2009,Apr,22261,11296,33557
EWR,1995,Sep,30577,2777,33354
EWR,2003,Dec,27926,5272,33198
EWR,1979,Jan,12810,233,13043
JFK,1980,Nov,14545,5435,19980
JFK,2009,Jan,22152,11687,33839
EWR,1992,Oct,31418,2309,33727
EWR,2007,Jul,27850,8292,36142
EWR,1995,Jan,30892,2427,33319
SWF,2007,Aug,1409,0,1409
EWR,1984,Jan,21921,178,22099
LGA,1979,Sep,21854,0,21854
JFK,1984,Jun,16020,7212,23232
LGA,2011,Apr,27822,1752,29574
JFK,2013,Sep,19453,13070,32523
JFK,1984,Nov,14301,6039,20340
JFK,2013,Feb,16987,10772,27759
LGA,2002,Mar,27320,1504,28824
LGA,1981,Jun,24778,0,24778
JFK,1986,Oct,12724,6928,19652
EWR,1990,Nov,28456,1804,30260
EWR,2014,Feb,19611,6192,25803
JFK,1994,Jun,20658,9163,29821
LGA,2008,Mar,29641,1870,31511
LGA,2012,Sep,26803,2936,29739
JFK,1987,Mar,12778,6481,19259
JFK,1998,May,17357,10240,27597
EWR,2006,Oct,29689,6927,36616
SWF,2008,Nov,739,4,743
LGA,2010,Oct,28909,2125,31034
EWR,2014,Apr,22619,7502,30121
LGA,1991,Aug,24911,1577,26488
LGA,1987,Dec,26757,104,26861
JFK,2010,Feb,17495,10106,27601
EWR,2006,Aug,30715,7913,38628
JFK,1996,Feb,15489,8907,24396
LGA,2003,Nov,29345,1520,30865
LGA,1998,Apr,26154,1909,28063
LGA,1985,Jan,25482,54,25536
LGA,1999,Apr,27429,2078,29507
EWR,2006,Jun,28819,7342,36161
EWR,2012,May,26160,8218,34378
LGA,1990,Jun,26354,1504,27858
SWF,2010,Mar,641,0,641
LGA,1995,Jul,25043,2002,27045
JFK,1987,May,13053,7479,20532
ACY,2014,Oct,845,7,852
LGA,1987,May,27996,124,28120
EWR,1988,Apr,26206,800,27006
JFK,1998,Feb,16759,8650,25409
EWR,2012,Nov,24926,7087,32013
JFK,1992,Nov,17283,7712,24995
LGA,1979,Jun,21434,0,21434
JFK,1990,Jun,12224,8740,20964
LGA,1982,Sep,21405,0,21405
ACY,2014,Aug,1077,4,1081
JFK,1996,Mar,17006,9845,26851
LGA,2010,Jun,27483,2169,29652
LGA,2008,Sep,28983,1929,30912
ACY,2012,Apr,977,2,979
SWF,2006,Sep,726,3,729
EWR,1984,May,24498,246,24744
LGA,1982,Jul,22375,0,22375
SWF,2010,Aug,643,0,643
JFK,2014,Jul,22427,16349,38776
EWR,1981,Feb,11829,52,11881
EWR,1979,Dec,12945,163,13108
JFK,1995,Mar,17103,8912,26015
EWR,1993,May,32781,2233,35014
EWR,2010,Oct,27504,7962,35466
JFK,1994,Dec,15572,8813,24385
ACY,2014,Apr,965,4,969
EWR,1978,Mar,12757,237,12994
EWR,1984,Dec,26490,279,26769
SWF,2014,Feb,490,0,490
LGA,1990,Jul,26644,1558,28202
SWF,2009,Mar,642,0,642
SWF,2014,Aug,627,0,627
LGA,1978,Feb,17460,0,17460
EWR,1988,Feb,24808,830,25638
EWR,2008,Sep,25662,7461,33123
JFK,1985,Oct,14653,6947,21600
LGA,1995,Dec,23754,1847,25601
SWF,2009,Sep,658,0,658
EWR,2004,Dec,29681,5811,35492
LGA,1982,Nov,20786,0,20786
EWR,1978,Jul,12322,336,12658
JFK,2008,May,23488,12622,36110
LGA,1998,Dec,27148,2057,29205
LGA,2011,Jun,28507,1830,30337
LGA,1984,Jul,25591,0,25591
EWR,1992,Apr,29965,2079,32044
EWR,1993,Dec,34068,2650,36718
EWR,1995,Apr,29502,2590,32092
LGA,1978,Nov,21704,0,21704
LGA,2005,Dec,30281,1604,31885
JFK,1978,Jul,15515,8374,23889
EWR,1987,Jan,27308,289,27597
LGA,1993,May,25575,1506,27081
EWR,1996,Jul,34780,3657,38437
EWR,1985,Nov,27459,322,27781
JFK,1989,Aug,12747,9279,22026
JFK,1980,Jul,15191,7541,22732
LGA,1987,Aug,28083,124,28207
LGA,2002,Aug,28583,1824,30407
JFK,2012,Jul,21348,14718,36066
EWR,1980,Apr,13069,185,13254
EWR,2002,Jul,28224,5876,34100
LGA,1984,Aug,26316,0,26316
EWR,1996,May,33782,3120,36902
JFK,1999,Jul,18249,11594,29843
EWR,1977,Jun,11073,253,11326
EWR,2013,Jun,25552,8025,33577
LGA,2004,Dec,30408,1826,32234
EWR,1985,Jan,27057,268,27325
JFK,1993,Feb,15258,7283,22541
JFK,2011,Aug,21083,13586,34669
JFK,1995,Sep,17687,9940,27627
EWR,1987,Apr,27282,306,27588
LGA,1980,Aug,22654,0,22654
LGA,1981,Nov,19730,0,19730
LGA,1990,Nov,25003,1495,26498
JFK,1985,Sep,13722,7266,20988
EWR,1986,Nov,27456,331,27787
LGA,2010,Feb,21984,1649,23633
SWF,2006,Dec,844,15,859
JFK,2007,May,25155,11708,36863
LGA,1992,Mar,25150,1470,26620
JFK,2009,Dec,20863,11547,32410
JFK,2011,Apr,21056,12198,33254
EWR,1984,Feb,21706,191,21897
LGA,2007,Dec,27542,1678,29220
EWR,1984,Oct,27015,302,27317
EWR,1995,Feb,28365,2307,30672
LGA,2000,Jun,25901,1808,27709
LGA,2014,Dec,26935,2372,29307
JFK,2000,Mar,17174,10182,27356
EWR,1982,Jun,12816,290,13106
EWR,2008,Feb,24626,6975,31601
EWR,1989,Jun,25369,1544,26913
EWR,1988,Oct,29404,925,30329
EWR,1993,Jan,31039,2285,33324
LGA,1982,Apr,20418,0,20418
JFK,2000,Apr,16206,10109,26315
JFK,2010,Dec,19702,11664,31366
JFK,2002,Sep,14519,9040,23559
JFK,2006,Nov,23192,10174,33366
JFK,1989,Dec,12081,7927,20008
EWR,1983,Apr,15776,231,16007
JFK,1977,Sep,14137,7518,21655
LGA,1990,Feb,23815,1400,25215
JFK,2005,May,18659,9867,28526
JFK,1983,Mar,14952,5463,20415
JFK,1990,Nov,11131,7332,18463
EWR,1989,Jan,27417,1088,28505
LGA,1999,Jan,24473,1767,26240
LGA,1999,Aug,27233,2109,29342
LGA,2012,Nov,26693,2682,29375
LGA,1994,Mar,25092,1534,26626
JFK,1977,Nov,13727,6218,19945
JFK,1978,Apr,14618,6416,21034
SWF,2007,Jun,1429,0,1429
JFK,2002,Nov,14102,8805,22907
JFK,1993,Apr,17326,8148,25474
SWF,2008,Dec,696,0,696
JFK,2007,Mar,24809,11100,35909
LGA,1988,Jan,25232,1217,26449
JFK,1995,Jan,15722,8656,24378
SWF,2012,Jan,744,0,744
JFK,2000,Oct,18880,10455,29335
JFK,1986,Sep,12530,7230,19760
EWR,1996,Feb,28667,2668,31335
SWF,2008,Mar,1635,0,1635
EWR,1991,Nov,27113,1816,28929
EWR,1987,Jul,27358,403,27761
JFK,1990,Jul,12875,9460,22335
LGA,1999,Jun,26428,2046,28474
LGA,1979,Aug,23784,0,23784
EWR,1987,Dec,27741,342,28083
LGA,1996,Dec,24755,2427,27182
LGA,1978,Apr,21362,0,21362
JFK,2013,Jan,19290,12139,31429
LGA,1981,Feb,19233,0,19233
ACY,2013,Sep,746,2,748
JFK,2009,Sep,20357,11614,31971
LGA,2004,Feb,28849,1576,30425
SWF,2009,Nov,627,2,629
SWF,2008,Jan,1584,0,1584
SWF,2009,Feb,595,0,595
LGA,2012,Jun,27908,2326,30234
JFK,1998,Sep,16785,10080,26865
EWR,2007,Jan,28479,6686,35165
ACY,2014,Mar,871,4,875
SWF,2011,Sep,701,0,701
JFK,1999,Oct,17860,10403,28263
LGA,2004,Jan,29091,1549,30640
SWF,2013,Mar,687,0,687
LGA,2005,Mar,30606,2017,32623
EWR,2007,Nov,27316,6930,34246
JFK,2005,Nov,18725,9289,28014
JFK,1987,Feb,11633,5766,17399
ACY,2012,Dec,694,2,696
LGA,1981,Oct,20247,0,20247
LGA,2004,May,30263,1823,32086
LGA,1992,Dec,23237,1345,24582
LGA,2005,Oct,30029,1904,31933
LGA,1985,Jun,25073,177,25250
JFK,1977,Jun,14537,7393,21930
EWR,1996,Oct,35239,3236,38475
EWR,2010,Apr,25601,7892,33493
LGA,1988,Jul,26466,1299,27765
LGA,1984,Nov,25030,0,25030
JFK,1997,Oct,19000,9995,28995
EWR,2014,Jan,22398,7049,29447
JFK,2006,Feb,15478,8538,24016
LGA,1998,Oct,27367,2033,29400
EWR,1989,Aug,28317,1659,29976
LGA,1991,Dec,24101,1410,25511
JFK,1977,Aug,15233,8227,23460
LGA,2002,Sep,27231,1745,28976
SWF,2010,Apr,630,0,630
JFK,1991,Jun,11737,8186,19923
LGA,1981,Apr,23178,0,23178
JFK,2006,Aug,21151,11965,33116
JFK,2013,Mar,20176,12746,32922
EWR,1985,Sep,26850,368,27218
JFK,2003,Dec,14657,8595,23252
JFK,2006,Oct,23416,10767,34183
JFK,1990,Apr,11918,7832,19750
EWR,1984,Mar,23300,232,23532
LGA,1988,Jun,26701,1279,27980
LGA,1990,Mar,26743,1620,28363
LGA,1985,Sep,24726,132,24858
EWR,1997,Dec,32169,4008,36177
LGA,2001,May,32043,1914,33957
EWR,2007,Apr,28113,7301,35414
LGA,1989,May,24831,1340,26171
JFK,2013,Nov,19013,12331,31344
EWR,1993,Aug,34820,2747,37567
JFK,2003,May,12867,8142,21009
LGA,2011,Nov,27443,1893,29336
JFK,1982,Jun,14633,6638,21271
LGA,1994,Dec,25691,1557,27248
EWR,1977,Aug,11635,264,11899
EWR,1983,Feb,13017,173,13190
JFK,1984,Sep,15435,7305,22740
LGA,2009,Feb,24703,1795,26498
EWR,2007,Feb,25070,6291,31361
EWR,1977,Apr,10847,313,11160
EWR,1990,Mar,28005,1589,29594
LGA,1998,Aug,26243,2031,28274
JFK,1996,Oct,19451,9730,29181
SWF,2012,Nov,610,7,617
LGA,1996,Sep,25261,2038,27299
LGA,1977,Dec,20719,0,20719
LGA,1995,Apr,25032,1550,26582
LGA,1992,Apr,24798,1423,26221
SWF,2009,Oct,677,1,678
LGA,1987,Jan,25449,100,25549
JFK,1978,May,14545,6951,21496
EWR,1992,Sep,30133,2338,32471
LGA,1980,Oct,21153,0,21153
JFK,2001,Nov,10932,7725,18657
EWR,1980,Jan,13451,136,13587
EWR,1978,Aug,13117,331,13448
JFK,1977,Jul,15305,8455,23760
EWR,2012,Jan,24328,7949,32277
JFK,2006,May,17918,10535,28453
LGA,2013,Dec,26366,2541,28907
JFK,1988,Apr,13775,7515,21290
JFK,1983,Dec,15442,6137,21579
EWR,2002,Aug,28984,5741,34725
EWR,1986,Mar,29700,350,30050
EWR,2006,Dec,29975,6755,36730
EWR,2006,May,29782,7136,36918
SWF,2014,Dec,623,0,623
JFK,1996,Jan,15222,9122,24344
LGA,2001,Aug,30546,1840,32386
EWR,1979,Aug,13844,304,14148
LGA,2004,Oct,31363,1975,33338
SWF,2009,Dec,658,0,658
JFK,1982,May,14586,6051,20637
JFK,2000,May,17293,10463,27756
JFK,1987,Apr,12323,6577,18900
JFK,2007,Sep,24513,11868,36381
JFK,1985,Jul,15262,8277,23539
LGA,2000,Feb,25674,1816,27490
LGA,2007,Apr,29974,1836,31810
JFK,2002,Jun,14144,9058,23202
EWR,1982,May,12643,235,12878
JFK,1998,Oct,16707,9971,26678
LGA,1987,Apr,27449,120,27569
LGA,1978,Sep,21956,0,21956
EWR,2013,Dec,25784,7100,32884
JFK,1978,Nov,14646,6027,20673
SWF,2010,Jun,640,0,640
EWR,2006,Nov,28677,6273,34950
SWF,2011,Oct,694,0,694
EWR,2011,Mar,26123,8687,34810
LGA,1994,May,25370,1618,26988
JFK,1980,Jun,14301,6860,21161
LGA,1988,Dec,26335,1225,27560
JFK,1985,Feb,12432,5477,17909
LGA,1984,Oct,26361,0,26361
EWR,1982,Nov,13567,161,13728
SWF,2009,Jun,639,0,639
EWR,1983,Nov,21267,180,21447
JFK,2011,Jan,18979,11567,30546
EWR,2010,Dec,23658,7512,31170
JFK,1981,Aug,13616,7160,20776
EWR,1989,Mar,26711,1104,27815
JFK,2012,Aug,21285,14651,35936
JFK,2004,Mar,15150,8676,23826
SWF,2011,Aug,757,0,757
LGA,2011,Oct,28889,1951,30840
LGA,1994,Nov,25165,1547,26712
JFK,2002,Jul,15198,9995,25193
EWR,2004,Nov,29089,5540,34629
EWR,2009,May,26262,7884,34146
LGA,2002,Nov,28385,1610,29995
LGA,1997,Jan,25982,1845,27827
SWF,2013,Jan,614,2,616
LGA,1997,Apr,25592,2010,27602
LGA,1995,Oct,26071,2084,28155
LGA,1994,Sep,25134,1579,26713
JFK,1980,Dec,15588,5769,21357
JFK,1996,Jun,18885,10161,29046
SWF,2014,Jun,604,0,604
LGA,2007,Sep,29446,1778,31224
LGA,1979,Mar,21590,0,21590
EWR,1980,Jul,13702,152,13854
JFK,2004,Jun,15954,9745,25699
JFK,2006,Dec,24099,11088,35187
JFK,2006,Sep,21445,10940,32385
LGA,2012,Aug,28793,3078,31871
JFK,1985,Dec,13844,6628,20472
LGA,1994,Oct,25940,1609,27549
LGA,2003,Mar,28417,1642,30059
LGA,1980,Apr,20126,0,20126
JFK,1986,Aug,13889,7949,21838
EWR,1979,Apr,11619,398,12017
JFK,2003,Jul,13621,10047,23668
EWR,1990,Apr,27791,1813,29604
ACY,2014,Feb,738,2,740
EWR,2013,May,26666,8039,34705
JFK,2011,Dec,20241,12237,32478
SWF,2007,Feb,1137,2,1139
JFK,2014,Mar,19924,13236,33160
JFK,1982,Dec,15050,5407,20457
JFK,1985,Apr,12917,6257,19174
JFK,1999,Mar,17156,9448,26604
ACY,2013,Mar,789,2,791
LGA,1994,Jul,25015,1591,26606
LGA,2005,Jun,29710,2043,31753
EWR,2007,Dec,26989,7237,34226
EWR,1995,Aug,32978,3127,36105
SWF,2014,Nov,565,0,565
EWR,1981,Apr,12874,116,12990
LGA,2005,Sep,30120,1961,32081
ACY,2014,May,1057,2,1059
JFK,1983,Jul,16159,7558,23717
ACY,2013,Dec,728,2,730
LGA,1982,Dec,21381,0,21381
EWR,1998,May,32308,4697,37005
EWR,2010,Nov,24890,7597,32487
JFK,1992,Mar,15255,7671,22926
LGA,1995,Sep,24951,1994,26945
JFK,1981,Jun,15001,6462,21463
EWR,2011,Oct,25470,7777,33247
LGA,1990,Apr,26498,1599,28097
LGA,2005,May,31681,2228,33909
JFK,2007,Feb,20309,9630,29939
LGA,1982,Jan,19326,0,19326
LGA,1999,Oct,27757,2070,29827
LGA,1991,Sep,24047,1427,25474
ACY,2012,Jan,808,0,808
LGA,2014,Apr,27717,2715,30432
LGA,2000,Jan,25244,1845,27089
JFK,1981,May,14689,6327,21016
LGA,2009,Mar,27473,1936,29409
LGA,1991,Jun,24167,1500,25667
EWR,1995,Mar,30769,2675,33444
SWF,2013,Sep,596,0,596
JFK,1984,Feb,14055,5454,19509
EWR,1988,Dec,29338,1011,30349
LGA,1996,Oct,25977,2112,28089
ACY,2012,Aug,1118,2,1120
SWF,2012,Jun,752,0,752
JFK,1981,Dec,13922,5328,19250
EWR,1982,Jan,12226,163,12389
LGA,1995,Mar,25989,1620,27609
LGA,2012,Jan,26961,1961,28922
LGA,2008,Aug,30078,1948,32026
LGA,1977,Jan,19542,0,19542
LGA,1981,Dec,20835,0,20835
EWR,1987,Sep,26435,373,26808
LGA,2010,Dec,25334,1738,27072
JFK,1998,Jul,17826,11265,29091
EWR,2004,Aug,30473,6874,37347
LGA,2012,Dec,26087,2596,28683
JFK,1992,Jun,18041,8668,26709
LGA,2003,Apr,28082,1470,29552
EWR,1990,Jun,27823,2172,29995
LGA,1999,Jul,26220,2000,28220
ACY,2012,Jul,1131,0,1131
EWR,1993,Sep,32010,2615,34625
EWR,2008,May,27932,8425,36357
JFK,1987,Aug,14756,8609,23365
LGA,1979,Jan,20841,0,20841
LGA,1989,Jun,24759,1311,26070
JFK,2010,Jan,20283,11434,31717
JFK,2005,Mar,18222,9738,27960
EWR,1997,Jul,34357,4443,38800
SWF,2006,Mar,755,1,756
EWR,1981,Nov,13442,91,13533
LGA,2008,Jan,29280,1886,31166
LGA,2005,Jul,30247,2129,32376
EWR,2011,Jul,26971,9229,36200
JFK,1977,Jan,13643,6402,20045
EWR,1984,Aug,26425,379,26804
LGA,1994,Jun,24985,1558,26543
LGA,2012,Apr,28610,2003,30613
LGA,1984,Apr,24623,0,24623
EWR,1979,Jun,12768,283,13051
JFK,1986,May,12553,7031,19584
EWR,1983,Jan,14750,156,14906
LGA,1996,Apr,25305,2029,27334
EWR,1995,Oct,31562,2660,34222
LGA,2009,Jan,25946,1773,27719
JFK,1980,Mar,14457,6202,20659
LGA,1982,Aug,23077,0,23077
JFK,2004,Dec,17105,10296,27401
EWR,2009,Nov,24697,6970,31667
LGA,1998,Jul,26586,2036,28622
JFK,2012,Sep,19760,13007,32767
LGA,2014,Oct,28444,2828,31272
SWF,2014,Sep,587,0,587
LGA,1980,Mar,20230,0,20230
JFK,1983,Aug,16594,7312,23906
JFK,1998,Aug,17547,11296,28843
JFK,1997,May,17904,9830,27734
LGA,2003,May,29473,1619,31092
EWR,1984,Nov,25614,255,25869
EWR,1989,Feb,24727,1032,25759
EWR,2012,Apr,26349,8302,34651
JFK,1994,May,19741,8572,28313
LGA,1979,Jul,23110,0,23110
JFK,2014,Aug,23200,16677,39877
LGA,1977,Oct,21465,0,21465
JFK,1991,Mar,10971,6991,17962
JFK,2001,Mar,14708,9670,24378
EWR,1991,Feb,24927,1637,26564
JFK,2002,Aug,15593,10156,25749
LGA,2013,Aug,29366,2950,32316
JFK,1998,Nov,16433,9048,25481
JFK,1983,Jun,14944,6802,21746
JFK,2010,Aug,21955,13987,35942
EWR,1978,Sep,12524,302,12826
LGA,1981,Aug,18984,0,18984
EWR,1989,May,26924,1349,28273
LGA,2014,Jun,27503,2675,30178
JFK,2001,Jan,15015,9447,24462
SWF,2014,Jul,635,4,639
JFK,1979,May,13456,7074,20530
EWR,1993,Feb,27814,1945,29759
LGA,1986,Jun,26300,118,26418
LGA,1980,Dec,20401,0,20401
JFK,2002,Oct,15062,9087,24149
JFK,1984,Apr,14895,6332,21227
JFK,1996,Jul,20081,11087,31168
LGA,2013,Feb,24003,2346,26349
EWR,1986,May,30674,321,30995
ACY,2013,Jul,905,3,908
EWR,1980,May,13112,193,13305
LGA,1987,Oct,28203,122,28325
LGA,1981,Jan,21959,0,21959
EWR,2002,Feb,24874,4519,29393
ACY,2012,Oct,749,2,751
JFK,1983,Feb,12589,4698,17287
EWR,2004,Feb,27212,5318,32530
JFK,2012,Jan,19507,11587,31094
EWR,2002,Sep,26407,5170,31577
EWR,1983,Sep,20422,238,20660
EWR,1982,Dec,14892,173,15065
LGA,2010,Aug,28610,2036,30646
EWR,1981,Jun,14319,150,14469
ACY,2014,Nov,963,0,963
EWR,1986,Oct,30393,320,30713
JFK,1989,Mar,11435,7895,19330
LGA,2009,Jun,26869,1824,28693
EWR,1997,Jun,32691,3952,36643
SWF,2011,Jan,624,0,624
JFK,2003,Nov,13518,8283,21801
LGA,1985,Apr,25242,60,25302
LGA,1996,Feb,22384,1755,24139
LGA,1979,Oct,22787,0,22787
SWF,2010,Jul,650,0,650
EWR,1981,Aug,12888,182,13070
SWF,2010,Oct,670,0,670
EWR,2004,Mar,29950,6016,35966
LGA,2011,Jan,26085,1736,27821
EWR,1986,Dec,28597,360,28957
EWR,1994,Dec,32724,2389,35113
EWR,2006,Jan,27667,6161,33828
LGA,2003,Jun,29110,1635,30745
JFK,1991,May,11745,7592,19337
JFK,2004,Jan,14371,8609,22980
LGA,1986,Nov,25683,120,25803
JFK,1985,Mar,11950,6023,17973
LGA,2004,Aug,30644,2014,32658
EWR,1995,May,29980,2593,32573
EWR,1980,Dec,12588,68,12656
JFK,1988,Oct,11553,8197,19750
JFK,1982,Apr,13690,5462,19152
JFK,2008,Apr,23491,12095,35586
JFK,2008,Nov,22210,11377,33587
JFK,1981,Jan,15777,5720,21497
EWR,1995,Jun,30195,2823,33018
LGA,2013,Jun,27097,2695,29792
JFK,1978,Sep,14848,7375,22223
LGA,2001,Jul,30616,1801,32417
EWR,2003,Sep,25968,5504,31472
EWR,1989,Oct,28645,1374,30019
LGA,2003,Jan,28797,1644,30441
SWF,2012,Feb,714,0,714
ACY,2012,Jun,1065,1,1066
LGA,1986,Mar,26172,120,26292
JFK,1979,Sep,14264,7425,21689
EWR,1980,Mar,13157,160,13317
EWR,1987,Jun,26995,281,27276
LGA,1993,Oct,25701,1579,27280
ACY,2013,Oct,712,3,715
LGA,2011,May,29335,1891,31226
LGA,1997,Jul,26104,1967,28071
JFK,2012,Apr,19935,12129,32064
JFK,1982,Aug,15666,7398,23064
EWR,1993,Nov,32198,2612,34810
JFK,2012,Mar,21143,12344,33487
EWR,2004,May,28791,6048,34839
EWR,2005,Dec,30074,6151,36225
LGA,2014,Jan,23778,2455,26233
JFK,2001,Jul,16169,11168,27337
JFK,2006,Jan,17501,9629,27130
ACY,2012,Sep,834,2,836
LGA,1994,Aug,26198,1631,27829
JFK,1995,Aug,18876,11253,30129
LGA,1988,Mar,27384,1312,28696
SWF,2012,Sep,589,0,589
JFK,2005,Jul,19396,11106,30502
LGA,2012,Oct,26288,2807,29095
LGA,2003,Dec,28124,1459,29583
EWR,1983,Jul,19849,294,20143
JFK,1984,Dec,13996,6348,20344
JFK,1979,Jan,14309,6397,20706
JFK,1994,Oct,17954,8884,26838
JFK,2007,Nov,24343,11236,35579
JFK,2011,Sep,20929,12432,33361
LGA,1983,May,23550,0,23550
EWR,1991,Jul,28315,2111,30426
LGA,1996,Aug,26207,2083,28290
JFK,2005,Aug,19843,10982,30825
EWR,2011,Sep,24808,7728,32536
EWR,2007,Sep,26416,7465,33881
EWR,1979,Jul,13354,298,13652
LGA,2007,May,31287,1949,33236
EWR,1987,Aug,27360,436,27796
EWR,1982,Feb,11502,142,11644
LGA,1977,Mar,20501,0,20501
JFK,2012,Dec,20063,12751,32814
EWR,1994,May,33424,2548,35972
LGA,1979,May,21041,0,21041
JFK,1991,Sep,11126,8282,19408
LGA,2010,Nov,28326,1858,30184
JFK,1996,Aug,20707,11227,31934
EWR,1997,May,32991,3769,36760
EWR,1997,Apr,33643,3445,37088
EWR,1990,Jan,26996,1478,28474
LGA,2008,Nov,26226,1838,28064
LGA,2002,Feb,24346,1165,25511
JFK,1995,Jun,17430,9784,27214
LGA,1984,Feb,21957,0,21957
LGA,2007,Jul,29690,1873,31563
EWR,1984,Jul,25756,391,26147
JFK,1994,Nov,17058,8255,25313
JFK,1987,Sep,13810,7666,21476
LGA,1983,Jun,23835,0,23835
JFK,1986,Feb,12272,5681,17953
JFK,1990,Jan,11953,7945,19898
EWR,1994,Feb,26821,2363,29184
JFK,1997,Jan,17304,9095,26399
JFK,1979,Dec,14460,6206,20666
SWF,2007,Sep,1296,0,1296
LGA,1982,Mar,20913,0,20913
LGA,1977,Sep,20800,0,20800
LGA,2000,Mar,28171,2099,30270
EWR,1977,Dec,11563,190,11753
EWR,1990,May,28076,2056,30132
EWR,2011,Aug,25286,8410,33696
EWR,1985,May,28651,320,28971
EWR,2010,Jun,25440,8420,33860
EWR,1996,Jun,33109,3298,36407
EWR,2004,Sep,27570,5887,33457
EWR,1994,Aug,33818,2792,36610
LGA,1995,Jan,25280,1545,26825
EWR,1977,Jul,11464,270,11734
JFK,1991,Feb,9821,5956,15777
EWR,1991,Sep,27911,1981,29892
JFK,1990,Dec,11234,7860,19094
EWR,1978,Jan,11075,148,11223
JFK,1998,Jun,16266,10278,26544
LGA,1992,Nov,24495,1441,25936
SWF,2012,May,842,0,842
EWR,2011,Nov,25469,7538,33007
EWR,1982,Sep,12945,183,13128
JFK,2000,Jan,15554,9689,25243
EWR,1988,Nov,27116,897,28013
JFK,2004,Oct,17643,9500,27143
EWR,2005,Jul,29008,7575,36583
LGA,2008,Oct,30284,2015,32299
LGA,2013,May,28029,2888,30917
SWF,2012,Aug,827,2,829
JFK,2003,Feb,12261,7698,19959
EWR,1978,May,12173,333,12506
LGA,1986,Dec,27035,103,27138
LGA,2006,Apr,30242,1830,32072
LGA,1989,Jan,26310,1278,27588
JFK,1981,Apr,14932,6074,21006
EWR,2007,Mar,28438,7016,35454
EWR,1979,Sep,12924,277,13201
SWF,2014,May,661,0,661
EWR,1985,Dec,28502,328,28830
LGA,1990,Oct,26536,1561,28097
JFK,1985,Jan,13993,6070,20063
LGA,1977,Feb,18212,0,18212
EWR,2005,Jun,28896,6694,35590
JFK,1986,Nov,11898,6375,18273
JFK,1990,Feb,11155,7189,18344
LGA,2013,Nov,26695,2677,29372
SWF,2012,Oct,619,0,619
EWR,2009,Apr,26454,8178,34632
LGA,1985,Nov,25021,116,25137
JFK,2002,Dec,14463,9319,23782
JFK,2007,Dec,24173,11975,36148
LGA,2013,Mar,27844,2810,30654
JFK,2011,Mar,21683,12567,34250
JFK,1996,May,17978,9778,27756
LGA,1998,Jun,24757,1897,26654
ACY,2013,May,928,3,931
JFK,1985,Nov,13194,6219,19413
EWR,2002,May,27393,5671,33064
LGA,2003,Aug,27996,1681,29677
EWR,1997,Aug,34908,4414,39322
EWR,2011,Jun,26336,8519,34855
JFK,2003,Oct,13922,8853,22775
EWR,1985,Aug,30253,417,30670
JFK,2012,Nov,18802,11830,30632
LGA,1996,Nov,24420,2488,26908
JFK,2013,May,20228,13013,33241
JFK,1987,Nov,12761,6778,19539
EWR,2008,Jan,26599,7399,33998
LGA,1987,Mar,27969,120,28089
LGA,1987,Sep,26969,118,27087
JFK,1997,Nov,17416,9657,27073
JFK,2008,Aug,24300,14184,38484
JFK,2008,Dec,22697,12101,34798
EWR,2013,Jan,24535,7846,32381
LGA,1977,Apr,20117,0,20117
LGA,1977,May,21005,0,21005
JFK,1984,Jan,14507,5884,20391
LGA,2007,Aug,31013,1956,32969
JFK,1980,May,14097,6608,20705
LGA,1993,Jan,25032,1486,26518
EWR,1997,Oct,33741,4161,37902
LGA,1995,Feb,22815,1374,24189
JFK,1983,Apr,14615,5784,20399
EWR,1985,Mar,28494,274,28768
LGA,1984,May,25915,0,25915
JFK,2007,Apr,24441,11163,35604
LGA,1987,Jul,27559,126,27685
JFK,1998,Jan,18206,9656,27862
JFK,1992,Aug,19028,9830,28858
JFK,1981,Sep,13480,6243,19723
EWR,2010,Jan,24560,7832,32392
LGA,1989,Apr,24200,1284,25484
EWR,2006,Feb,25133,5668,30801
LGA,1981,Jul,26231,0,26231
JFK,2004,May,15602,9065,24667
JFK,1980,Sep,13724,6550,20274
LGA,2001,Apr,31356,1791,33147
LGA,1982,May,21599,0,21599
EWR,2008,Nov,26252,6802,33054
JFK,1989,May,11473,8330,19803
JFK,2003,Aug,13327,10015,23342
ACY,2012,Nov,718,2,720
LGA,1982,Oct,21674,0,21674
EWR,1992,Aug,30815,2604,33419
EWR,2005,Feb,25686,5475,31161
EWR,1982,Jul,12906,292,13198
LGA,2003,Feb,23659,1340,24999
JFK,1982,Sep,14428,6529,20957
EWR,1980,Jun,12820,168,12988
JFK,1980,Jan,14781,6155,20936
JFK,2010,Jun,20296,12890,33186
EWR,1997,Mar,33356,3361,36717
EWR,1982,Apr,12347,198,12545
LGA,1977,Nov,20453,0,20453
LGA,1997,Jun,25626,1954,27580
JFK,1989,Jul,11934,9530,21464
EWR,2003,Jun,27417,5830,33247
LGA,1985,Aug,27641,184,27825
JFK,2005,Oct,18573,9846,28419
LGA,1990,Aug,27346,1582,28928
JFK,2012,May,20105,12528,32633
JFK,1977,Dec,14237,6634,20871
LGA,1977,Aug,22065,0,22065
EWR,2003,Jul,28303,6167,34470
LGA,1990,May,26884,1561,28445
LGA,1998,May,25909,1961,27870
JFK,1989,Feb,10607,6927,17534
EWR,1993,Apr,31839,2353,34192
LGA,1985,Oct,27084,121,27205
LGA,2006,Jul,29979,1830,31809
EWR,1980,Aug,13175,140,13315
SWF,2007,May,1405,0,1405
JFK,1993,May,18001,8639,26640
EWR,1996,Mar,30962,3003,33965
EWR,2006,Apr,29324,6679,36003
EWR,2005,May,29349,6304,35653
ACY,2012,Mar,1005,4,1009
LGA,1983,Feb,18721,0,18721
EWR,1987,May,26865,299,27164
LGA,2003,Sep,28474,1618,30092
JFK,1991,Apr,11269,6836,18105
EWR,1986,Apr,29680,337,30017
LGA,1989,Aug,26916,1651,28567
JFK,2008,Jul,24553,14244,38797
JFK,2001,Oct,12166,8353,20519
JFK,2013,Oct,20135,13049,33184
JFK,1986,Dec,12885,6564,19449
LGA,1998,Mar,26717,1971,28688
SWF,2010,Nov,636,0,636
EWR,1979,May,12176,420,12596
SWF,2007,Apr,1295,0,1295
EWR,1994,Apr,32935,2635,35570
EWR,1988,May,26783,827,27610
EWR,1992,Nov,29539,2272,31811
LGA,2001,Feb,27936,1535,29471
EWR,1984,Apr,23344,242,23586
JFK,2009,Jun,23155,12335,35490
JFK,2013,Jun,20317,13769,34086
JFK,2011,Jun,21747,13154,34901
EWR,1982,Aug,13496,292,13788
LGA,1999,Dec,27309,1969,29278
LGA,2011,Dec,26872,1955,28827
EWR,1985,Apr,28104,305,28409
JFK,2005,Sep,18065,9990,28055
JFK,1980,Apr,14088,6104,20192
LGA,2005,Jan,29044,1943,30987
JFK,2012,Oct,18249,11524,29773
JFK,1994,Feb,14717,6843,21560
SWF,2011,Apr,705,7,712
EWR,2002,Jan,26961,4854,31815
JFK,1988,Mar,13782,7437,21219
EWR,2013,Aug,27056,8299,35355
JFK,2004,Aug,18326,11208,29534
LGA,1993,Dec,25202,1528,26730
LGA,1988,May,26638,1318,27956
SWF,2008,Apr,1369,0,1369
LGA,1978,Dec,21333,2,21335
EWR,1980,Nov,12233,116,12349
LGA,1985,Dec,25858,106,25964
LGA,1989,Sep,24671,1680,26351
LGA,1988,Apr,26600,1267,27867
LGA,1987,Nov,26249,117,26366
JFK,1991,Aug,12573,9420,21993
LGA,1978,Jun,22008,0,22008
SWF,2009,Jul,684,0,684
LGA,1989,Dec,25512,1640,27152
LGA,1997,Oct,26867,2053,28920
LGA,2002,May,28016,1605,29621
SWF,2008,Jun,1227,0,1227
LGA,2007,Jan,30578,1699,32277
JFK,1981,Nov,12867,5124,17991
JFK,1983,Nov,15044,5755,20799
EWR,2008,Oct,28480,7429,35909
LGA,2000,Dec,30141,1599,31740
EWR,2001,Sep,23147,4746,27893
EWR,2015,Apr,26181,7884,34065
JFK,2002,Mar,13652,8349,22001
EWR,2003,Apr,26766,5272,32038
LGA,2015,Feb,22929,2025,24954
EWR,2005,Oct,29139,6258,35397
EWR,1999,Sep,30911,4798,35709
JFK,2015,Jan,18777,13135,31912
EWR,1999,Feb,28843,4080,32923
EWR,2015,Dec,26833,7734,34567
JFK,2015,Nov,20253,13202,33455
EWR,2000,Sep,30037,5329,35366
ACY,2015,Apr,901,3,904
JFK,2014,Sep,20651,14011,34662
LGA,2015,Sep,27241,2166,29407
JFK,2015,Mar,20189,13523,33712
JFK,2002,Feb,11688,7346,19034
LGA,2015,Jul,28744,2502,31246
EWR,2000,Dec,29645,4732,34377
EWR,1999,May,31165,4901,36066
JFK,2015,May,22016,14855,36871
EWR,2003,Jan,26385,5366,31751
JFK,2014,Jun,21846,15137,36983
ACY,2015,Jul,992,39,1031
ACY,2015,Aug,922,41,963
EWR,2000,Feb,29481,4504,33985
EWR,2001,May,32751,5293,38044
SWF,2015,Jun,597,0,597
LGA,2015,Apr,27880,2456,30336
JFK,2015,Oct,22111,14175,36286
EWR,2001,Feb,29291,4218,33509
JFK,2015,Dec,21740,14702,36442
EWR,2015,Jul,27470,8436,35906
JFK,2014,Oct,20935,13852,34787
EWR,1999,Jul,32028,5238,37266
SWF,2015,Feb,450,0,450
JFK,2001,Apr,14975,9776,24751
ACY,2015,Sep,725,8,733
JFK,2014,Feb,16225,11236,27461
LGA,2015,Mar,26986,2302,29288
EWR,1998,Jun,30809,4351,35160
LGA,2015,Aug,29032,2428,31460
EWR,1999,Jun,31454,4939,36393
EWR,2015,Sep,25449,7091,32540
EWR,1999,Apr,31871,4748,36619
EWR,2014,Sep,24380,7107,31487
EWR,2015,Jan,23141,7027,30168
EWR,2001,Jun,31384,5489,36873
JFK,2015,Jun,21936,15607,37543
EWR,2001,Jan,31583,4883,36466
EWR,2002,Dec,26939,5114,32053
EWR,2002,Jun,26820,5670,32490
SWF,2015,Apr,575,0,575
EWR,1998,Dec,32238,4385,36623
JFK,2001,Aug,16287,11342,27629
JFK,2004,Sep,16436,9736,26172
JFK,2001,May,16731,9947,26678
EWR,2015,May,26071,7582,33653
EWR,2001,Jul,32515,6296,38811
EWR,2000,Oct,31889,5040,36929
EWR,2004,Oct,30339,5945,36284
EWR,2015,Jun,26244,7645,33889
JFK,2015,Feb,17510,11652,29162
JFK,2015,Sep,21119,14509,35628
JFK,1999,Jun,17888,10241,28129
EWR,1999,Oct,32184,4837,37021
EWR,2000,Jan,28399,4642,33041
JFK,2000,Feb,15559,9135,24694
EWR,2004,Jun,29423,6172,35595
LGA,2015,May,27384,2595,29979
JFK,2015,Aug,23323,17086,40409
EWR,1998,Nov,30742,4219,34961
LGA,2015,Nov,26552,1932,28484
EWR,1999,Dec,32045,4500,36545
EWR,1999,Aug,33184,5368,38552
ACY,2015,May,964,16,980
EWR,2015,Feb,21203,6386,27589
EWR,2001,Apr,32303,5011,37314
LGA,2015,Jun,26808,2532,29340
EWR,1998,Jul,33250,4855,38105
ACY,2015,Feb,785,1,786
EWR,2001,Mar,31583,4924,36507
SWF,2015,Dec,583,0,583
ACY,2015,Oct,694,4,698
ACY,2015,Mar,907,3,910
EWR,2000,Nov,30180,4798,34978
SWF,2015,Oct,517,0,517
LGA,2014,Nov,26286,2315,28601
EWR,1999,Jan,28938,4447,33385
JFK,2002,Jan,12394,8014,20408
JFK,2004,Feb,13972,8068,22040
LGA,2015,Jan,25200,2176,27376
JFK,2001,Feb,13047,8724,21771
EWR,2014,Dec,25703,8024,33727
EWR,2001,Oct,27812,4734,32546
EWR,2000,Apr,30279,4851,35130
EWR,2015,Aug,27102,8322,35424
EWR,2006,Mar,31059,6829,37888
EWR,2015,Nov,26469,6880,33349
JFK,2015,Jul,23006,17077,40083
JFK,1998,Dec,16847,9728,26575
EWR,2000,Jun,29354,5287,34641
JFK,1999,Feb,14893,8132,23025
JFK,2015,Apr,21055,14203,35258
EWR,2000,Mar,32753,5055,37808
SWF,2015,Jan,481,1,482
EWR,1998,Mar,32516,4366,36882
ACY,2015,Jan,831,1,832
JFK,2004,Jul,17290,11174,28464
EWR,2014,Oct,25024,7329,32353
SWF,2015,Jul,608,4,612
ACY,2015,Jun,927,36,963
JFK,1999,Jan,15313,9453,24766
EWR,2000,Aug,31653,5672,37325
EWR,1998,Oct,32502,4556,37058
ACY,2015,Nov,744,0,744
EWR,2015,Oct,27294,7180,34474
JFK,1999,Nov,16532,9779,26311
LGA,2015,Oct,28360,2184,30544
EWR,1998,Aug,32505,4886,37391
EWR,2004,Jul,29568,6764,36332
JFK,2014,Nov,19389,13176,32565
EWR,1999,Nov,30571,4497,35068
EWR,2005,Apr,28988,6172,35160
SWF,2015,Aug,593,0,593
EWR,1999,Mar,32501,4654,37155
SWF,2015,Mar,485,2,487
SWF,2015,Sep,567,0,567
SWF,2015,May,617,4,621
EWR,2000,Jul,30542,5671,36213
EWR,2000,May,30393,5238,35631
EWR,2001,Aug,33570,6333,39903
SWF,2015,Nov,501,0,501
EWR,2003,Oct,29197,5558,34755
JFK,2002,Apr,13774,8314,22088
EWR,1998,Apr,32666,4473,37139
EWR,2015,Mar,25189,7652,32841
JFK,2001,Dec,11362,8328,19690
LGA,2015,Dec,26167,1862,28029
EWR,1998,Sep,30795,4275,35070
ACY,2015,Dec,759,1,760
JFK,2005,Apr,18079,9495,27574
JFK,2014,Dec,20601,14140,34741
